1111111111111
1P010000000C1
1000011111001
100011E0000N1
1111111111111
