1111111111111111111111111111111111
100000000000000C001E0C000000001001
1010010100100000101001000000010101
1010010010101010001001000000010101
1010010010101010001001000000010101
1010010010101010001000100000010101
1010010010101010001001000000010101
1010010010101010001001000000010101
1010010010101010001001000000010101
1010010010101010001001000000010101
1PC000000C000000000000000000000001
1111111111111111111111111111111111
1111111111111111111111111111111111
1111111111111111111111111111111111
