1111111111111111111111111111111111
1000000000000000001000000000001001
1010010100100000101001000000010101
1010010010101010001001000000010101
1010010010101010001001000000010101
1010010010101010001000100000010101
1111110010101010001001000000010101
1010010010101010001001000000010101
1010010010101010001001000000010101
1010010010101010001001000000010101
1000000000000000000000000000000001
1111111111111111111111111111111111
1111111111111111111111111111111111
1111111111111111111111111111111111
1111111111111111111111111111111111
1000000000000000001000000000001001
1010010100100E00101001000000010101
1010010010101010001001000000010101
1010010010101010001001000000010101
1010010010101010001000100000010101
11111100101010C0001001000000010101
1010010010101010001001000000010101
1010010010101010001001000000010101
1010010010101P10001001000000010101
1000000000000000000000000000000001
1011111111111111111111111111111111
1011111111111111111111111111111111
1011111111111111111111111111111111
1011111111111111111111111111111111
1000000000000000001000000000001001
1010010100100000101001000000010101
1010010010101010001001000000010101
1010010010101010001001000000010101
1010010010101010001000100000010101
1111110010101010001001000000010101
1010010010101010001001000000010101
1010010010101010001001000000010101
1010010010101010001001000000010101
1000000000000000000000000000000001
1011111111111111111111111111111111
1011111111111111111111111111111111
1011111111111111111111111111111111
1011111111111111111111111111111111
1000000000000000001000000000001001
1010010100100000101001000000010101
1010010010101010001001000000010101
1010010010101010001001000000010101
1010010010101010001000100000010101
1111110010101010001001000000010101
1010010010101010001001000000010101
1010010010101010001001000000010101
1010010010101010001001000000010101
1000000000000000000000000000000001
1111111111111111111111111111111111
1111111111111111111111111111111111
1111111111111111111111111111111111
