1111111111111
1PC1CCCCCCCC1
1CCCC11111CC1
1CCC11ECCCCN1
1111111111111
