11111
1P111
10NC1
1C111
1E111
11111
